
111111111111
1P0000000CE1
1MMMM00MMMM1
1MMMM00MMMM1
100000000001
100000000001
100000000001
1MMMM00MMMM1
1MMMM00MMMM1
100000000001
111111111111
