111111111111
1P00000000E1
1MMMM00MMMM1
1MMMM00MMMM1
1C0000000001
100000000001
10000000C001
1MMMM00MMMM1
1MMMM00MMMM1
1C0000000001
111111111111
