11111111111111111111111111111
10000C000000000C0000000000001
1000000000000000000000000C001
1C00000000000000000C000000001
1000000C0C00000000000000000C1
10M0M0M0000000000010011111111
10000C00000C00000010011111111
10M0M0M00M0M0M0M0M10011111111
1000000000000000C010011111111
10M0M0M00M0M0M0M0M10011111111
100000C0000000000010011111111
10M0M0M00M0M0M0M0M10011111111
1000C00000C00000001000E111111
10M0M0M00M0M0M0M0M10001111111
10000000000000000C10011111111
10M0M0M00M0M0M0M0M10011111111
1000C000000000000010011111111
10M0M0M00M0M0M0M0M10011111111
10000P00000000000000011111111
11111111111111111111111111111
