1111111111111
1C00000000C11
1WWWW00WWWW11
1XXXX00XXXX11
1000C00C00011
1WWWW00WWWW11
1C00000000011
1WWWW00000P11
1HHHH000000E1
1111111111111
