111111111111
1P0CCCCCCCE1
1MMMMCCMMMM1
1MMMMCCMMMM1
1CCCCCCCCCC1
1CCCCCCCCCC1
1CCCCCCCCCC1
1MMMMCCMMMM1
1MMMMCCMMMM1
1CCCCCCCCCC1
111111111111
