111111111111
1P11111110E1
100000110011
1111010001C1
110000001001
100011000011
1C01C0011.11
111111111111
