11111111111111111111111111111111111111111111111111111111111111
1P00000000000000000000000000000CCCCCCCCCCCCCCCCCCCCCCCCCCCCCE1
11111111111111111111111111111111111111111111111111111111111111
