11111111111111111111111111111111111111111111111111111111111111
1PCCCCCCCCCCCCCCCCCCCCCCCCCCCCC00000000000000000000000000000E1
11111111111111111111111111111111111111111111111111111111111111
