111111111111111111111111111111
1P10000000000100001000000110C1
101010111111010110001111011001
10001010C101000011111100000001
111110000001111010001001111101
1C01001110111C1000101000000101
10010000000C101111101000000101
100111001111100000000001111101
100000000000000011011001000001
11111100000110010010010101C101
1C0111111100000010001000000001
110000011111110001010001111111
111000000111100000100000111111
111100000000000000000000001111
111001100000110001111111000111
110001100000110011111111100011
1001011000001100110000C1100011
1100011C000C110000000011100011
111001111111110000000111000111
110001111111110000001110001111
1C010000000C110000011100011111
111111111000110000111000011111
110000001000110001110000000111
1001110C1000110011111111100011
101101111000110011111111100011
100100000000000000000000000001
110111011111111111001100111111
10011000100010C010001100110001
1000001000100010000000000001E1
111111111111111111111111111111
