111111
100001
10P001
100EC1
111111
