11111
1P0C1
10001
10CC1
1C001
10C01
100C1
1CC01
10001
1C0C1
1C0C1
1C0C1
1C0C1
1CCC1
10001
10CC1
1C001
10C01
100C1
1CC01
10001
10CC1
1C001
10C01
100C1
1CC01
10001
1C0C1
1C0C1
10C01
10C01
10C01
10001
10C01
10C01
10C01
10C01
10001
10C01
1E001
11111
