11111111111
1C0000000C1
10100000101
10000000001
10000000001
10000P00001
10000000001
10000000001
10100000101
1C0000000E1
11111111111
