1111111111
10P0C0C0E1
1101010101
1010101011
1101010101
1010101011
1101010101
1010101011
1101010101
1111111111
