11111111111111111111111111111111111111111111111111111111111111
1PC0C0C0C0C0C0C0C0C0C0C0C0C0C0C0C0C0C0C0C0C0C0C0C0C0C0C0C0C0E1
11111111111111111111111111111111111111111111111111111111111111
