11111111111111111111111111111111
1P0000000000000000000C0000C00001
100000000000000000000C0000C00001
10000000000000000000000000000001
100000000000000000000C0000C00001
1E00000000000000000000CCCC000001
11111111111111111111111111111111
10000000000000000000000000000001
10000000000000000000000000000001
10000111100000000000000111100001
10001111110000000000001111110001
10001111110000000000001111110001
10001111110000000000001111110001
10001111110000000000001111110001
10001111110000000000001111110001
10001111110000000000001111110001
10001111110000000000001111110001
10001111110000000000001111110001
10001111110000000000001111110001
10000111100000000000000111100001
10000000000000000000000000000001
10000000000000000000000000000001
10000111100000000000000111100001
10001111110000000000001111110001
10000111111000000000011111100001
10000111111000000000011111100001
10000011111100000000111111000001
10000001111111100111111110000001
10000000011111111111111000000001
10000000000001111110000000000001
10000000000000000000000000000001
11111111111111111111111111111111
